#################################################
#........###..........................#.........#
#........#B#....##..........##........#.........#
#........#......##..........##........#.........#
#........#............................#.........#
#........#............................#.........#
#........#......##..........##........#.........#
#........#......##..........##........#.........#
#........#..................##........#.........#
#@..Q....#......................................#
#........#..................##........#.........#
#........#......##..........##........#.........#
#........#......##..........##........#.........#
#........#............................#.........#
#........#............................#.........#
#........#......##..........##........#.........#
#........#.#....##..........##........#.........#
#........###..........................#.........#
#################################################